#Please keep tags sorted on alphabetical use when you add/remove country tags

#春秋战国时期主要大国
CHU = "countries/chuguo.txt"
HAN = "countries/hanguo1.txt"
JIN = "countries/jinguo.txt"
PAP = "countries/papal.txt"
QIG = "countries/qiguo1.txt"
QIN = "countries/qin.txt"
WEI = "countries/weiguo2.txt"
WUG = "countries/wuguo.txt"
YAN = "countries/yanguo.txt"
YGO = "countries/yueguo.txt"
#春秋战国时期主要的二等国家
CAI = "countries/caiguo.txt"
CHE = "countries/chenguo.txt"
LUG = "countries/luguo1.txt"
SON = "countries/Songguo.txt"
ZGO = "countries/zhengguo.txt"
#河北地区诸侯
DAI = "countries/daiguo1.txt"
JIW = "countries/jiguo4.txt"
WEG = "countries/weiguo1.txt"
XGO = "countries/xingguo.txt"
#河北戎狄国家
BER = "countries/beirong.txt"
CHA = "countries/changdi.txt"
FEI = "countries/feiguo1.txt"
GUG = "countries/guguo1.txt"
GUZ = "countries/guzhu.txt"
JIS = "countries/jiashi.txt"
LZG = "countries/lingzhi.txt"
TUH = "countries/tuhe.txt"
WUZ  = "countries/wuzhong.txt"
XIY = "countries/xianyu.txt"
ZHS = "countries/zhongshang.txt"
#山西地区诸侯
HUO = "countries/huo.txt"
JIC = "countries/jiguo2.txt"
LIO = "countries/liguo2.txt"
PUG = "countries/puguo.txt"
QUW = "countries/quwo.txt"
WEO = "countries/weiguo3.txt"
XUN = "countries/xunguo.txt"
YNG = "countries/yangguo2.txt"
YUG = "countries/yuguo1.txt"
ZHO = "countries/zhaoguo.txt"
#山西戎狄国家
CHI = "countries/chidi.txt"
DOC = "countries/duochen.txt"
DAR = "countries/darong.txt"
GAL = "countries/gaoluoshi.txt"
LIR = "countries/lirong.txt"
LIY = "countries/liuyu.txt"
LUS = "countries/lushi.txt"
QIY = "countries/qiuyou.txt"
QJR = "countries/qiangjiuru.txt"
#山东地区诸侯
BIY = "countries/biyang.txt"
CHG = "countries/chengguo.txt"
DXU = "countries/duanxu.txt"
FEG = "countries/feiguo2.txt"
GAO = "countries/gaoguo.txt"
JII = "countries/jiguo3.txt"
JIG = "countries/jiguo1.txt"
LUC = "countries/luguo2.txt"
MAO = "countries/maoguo.txt"
MOU = "countries/mouguo.txt"
QIO = "countries/qigoo.txt"
SUG = "countries/suiguo2.txt"
SHI = "countries/shiguo.txt"
TAN = "countries/tanguo.txt"
TEN = "countries/tengguo.txt"
XNG = "countries/xiangguo1.txt"
XZG = "countries/xiaozhuguo.txt"
YGG = "countries/yangguo3.txt"
YUO = "countries/yuguo2.txt"
ZHA = "countries/zhangguo.txt"
ZHU = "countries/zhuguo.txt"
ZNG = "countries/zengguo.txt"
#山东夷狄国家
LAI = "countries/laiguo.txt"
YIG = "countries/yiguo.txt"
JIE = "countries/jieguo.txt"
JUG = "countries/juguo.txt"
QIC = "countries/qiguo2.txt"
TAG = "countries/tan.txt"
XUE = "countries/xue.txt"
#关中地区诸侯
HNG = "countries/hanguo2.txt"
RGO = "countries/ruiguo.txt"
XGG = "countries/xiaoguoguo.txt"
#关中戎狄国家
BAI = "countries/baidi.txt"
BOG = "countries/boguo.txt"
GUI = "countries/gui.txt"
HUR = "countries/huan.txt"
JIA = "countries/jiaguo.txt"
JIR = "countries/jirong.txt"
LHR = "countries/luhunrong.txt"
LNG = "countries/liangguo.txt"
MZR = "countries/mianzhurong.txt"
QIA = "countries/qiang.txt"
QRO = "countries/qianrong.txt"
WUS = "countries/wushi.txt"
YQU = "countries/yiqu.txt"
YUE = "countries/yuezhi.txt"
LSS = "countries/lishanshi.txt"
XSG = "countries/xishen.txt"
PXS = "countries/pengxishi.txt"
MJR = "countries/maojinrong.txt"
#河南地区诸侯
CAO = "countries/cao.txt"
DAG = "countries/daiguo2.txt"
DBG = "countries/dongbugeng.txt"
DGG = "countries/dongguoguo.txt"
FGO = "countries/fanguo.txt"
GNG = "countries/gongguo.txt"
GUO = "countries/guoguo.txt"
HAG = "countries/huaguo.txt"
JOG = "countries/jiaoguo2.txt"
KUA = "countries/kuaiguo.txt"
LIA = "countries/liaoguo1.txt"
NYA = "countries/nanyan.txt"
SHN = "countries/shenguo.txt"
WEN = "countries/wenguo.txt"
XBG = "countries/xibugeng.txt"
XIA = "countries/Xiao.txt"
XNC = "countries/xiangguo2.txt"
XUG = "countries/xuguo.txt"
YIN = "countries/yingguo1.txt"
YUA = "countries/yuanguo.txt"
YOG = "countries/yongguo2.txt"
ZHG = "countries/zhouguo.txt"
#新建
ZMI = "countries/zhengguomi.txt"
ZZI = "countries/zhengguozha.txt"
#江汉地区诸侯
ANG = "countries/tanggoo.txt"
DEG = "countries/dengguo.txt"
EGU = "countries/erguo.txt"
FAN = "countries/fangguo.txt"
GUW = "countries/guguo2.txt"
HEN = "countries/zhenguo.txt"
HUA = "countries/Huangguo.txt"
HUG  = "countries/huguo.txt"
JAG = "countries/jiangguo1.txt"
JIO = "countries/jiaoguo1.txt"
JUN = "countries/junguo.txt"
KUI = "countries/kuiguo.txt"
LAO = "countries/liaoguo2.txt"
LIG = "countries/liguo1.txt"
LUK = "countries/luguo3.txt"
LUO = "countries/luoguo.txt"
QUA = "countries/quanguo.txt"
RUO = "countries/ruoguo.txt"
SHE = "countries/shengguo.txt"
SUI = "countries/suiguo1.txt"
YON = "countries/yongguo1.txt"
YUN = "countries/yunguo.txt"
ZOU = "countries/zhouguo.txt"
#淮海地区诸侯
DUN = "countries/dunguo.txt"
JNG = "countries/jiangguo2.txt"
LIU = "countries/liu.txt"
SHU = "countries/shuguo.txt"
SJG = "countries/shujiu.txt"
SLG = "countries/shuliao.txt"
SYG = "countries/shuyong.txt"
XGU = "countries/gongxian.txt"
XIG = "countries/xiguo.txt"
YAG = "countries/yangguo1.txt"
YIC = "countries/yingguo2.txt"
#淮海蛮夷国家
CHO = "countries/chaoguo.txt"
HNX = "countries/hanguo3.txt"
HYI = "countries/huaiyi.txt"
YXU = "countries/yingxu.txt"
ZHL = "countries/zhongli.txt"
ZWG = "countries/zhongwu.txt"
ZLA = "countries/zhoulai.txt"
#西南地区国家
BAG = "countries/baguo.txt" 
BAO = "countries/baoguo.txt"
DGU = "countries/dianguo.txt"
JUU = "countries/juguu.txt"
MIA = "countries/miao.txt"
SGU = "countries/shuhan.txt"
QON = "countries/qiongguo.txt"
ZUO = "countries/zuoguo.txt"
YLG = "countries/yelang.txt"
ZKG = "countries/zangke.txt"
#百越国家
LUY = "countries/luoyue.txt"
MIN = "countries/minyue.txt"
NAN = "countries/nanyue.txt"
OUY = "countries/ouyue.txt"
XOU = "countries/xiou.txt"
YYG = "countries/yangyue.txt"
#北方外族国家
DHU = "countries/donghu.txt"
LHU = "countries/linhu.txt"
LOU = "countries/loufang.txt"
SUS = "countries/sushen.txt"
HZS = "countries/Hezongshi.txt"
XHM = "countries/xiuhun.txt"
YLR = "countries/yiluo.txt"
JSG = "countries/jishihouguo.txt"
XNU = "countries/xiongnu.txt"
#项羽十八诸侯
HNW = "countries/hanwang.txt" #汉
XCW = "countries/xichubawang.txt" #西楚
YOW = "countries/yongwang.txt"
SAI = "countries/saiwang.txt" #塞
DIW = "countries/diwang.txt" #翟
SCW = "countries/henanwang.txt" #河南
LJW = "countries/linjiangwang.txt" #临江
JJW = "countries/jiujiangwang.txt" #九江
YNW = "countries/yinwang.txt" #殷
CSW = "countries/changshanwang.txt" #常山
HSW = "countries/hengshanwang.txt" #衡山
JDW = "countries/jiaodongwang.txt" #胶东
JBW = "countries/jibeiwang.txt" #济北
LDW = "countries/liaodongwang.txt" #辽东

#隐藏国家
BEI = "countries/beiguo.txt"
GAN = "countries/guanguo.txt"
YSG = "countries/yinshang.txt"
#特殊国家
REB = "countries/rebels.txt"
PIR = "countries/pirates.txt"
NAT = "countries/natives.txt"
NPC = "countries/xitongguojia.txt"
SZG = "countries/shenzhiguo.txt"
#新建
ZHI = "countries/zhibo.txt"#智
FAS = "countries/fanshi.txt"#范
ZXS = "countries/zhongxingshi.txt"#中行
HDA = "countries/handan.txt"#邯郸
QYA = "countries/quyan.txt"#a衍
XAY = "countries/xianyu2.txt"#猃狁
YNO = "countries/yanguo2.txt"#奄国
YGN = "countries/yuguo3.txt"#鱼国
XFU = "countries/xifu.txt"#昔阝
PIZ = "countries/pingzhou.txt"#平周
#晋
JGS = "countries/jingongshi.txt"#晋公室
JHS = "countries/jingongshi.txt"#晋狐氏
JAS = "countries/jingongshi.txt"#晋韩氏
JWS = "countries/jingongshi.txt"#晋魏氏
JZS = "countries/jingongshi.txt"#晋赵氏
JNS = "countries/jingongshi.txt"#晋先氏
JLS = "countries/jingongshi.txt"#晋栾氏
JSS = "countries/jingongshi.txt"#晋士氏
JVS = "countries/jingongshi.txt"#晋荀氏
JXS = "countries/jingongshi.txt"#晋胥氏
JYS = "countries/jingongshi.txt"#晋欲氏
#西域诸国
DHF = "countries/xiyu/duhufu.txt"
XYA = "countries/xiyu/diguoxiyu.txt"
XYB = "countries/xiyu/gonghexiyu.txt"
XYC = "countries/xiyu/youmuxiyu.txt"
XYD = "countries/xiyu/nanxiyu.txt"
XYE = "countries/xiyu/beixiyu.txt"
XYF = "countries/xiyu/pishan.txt"
XYG = "countries/xiyu/nandou.txt"
XYH = "countries/xiyu/weili.txt"
XYI = "countries/xiyu/ruoqiang.txt"
XYJ = "countries/xiyu/yutian.txt"
XYK = "countries/xiyu/qule.txt"
XYL = "countries/xiyu/ronglu.txt"
XYM = "countries/xiyu/qiemo.txt"
XYN = "countries/xiyu/jie.txt"
XYO = "countries/xiyu/cheshi.txt"
XYP = "countries/xiyu/guizi.txt"
XYQ = "countries/xiyu/gumo.txt"
XYR = "countries/xiyu/wensu.txt"
XYS = "countries/xiyu/wusun.txt"
XYT = "countries/xiyu/dawan.txt"
XYU = "countries/xiyu/loulan.txt"
XYV = "countries/xiyu/yumi.txt"
XYW = "countries/xiyu/jingjue.txt"
XYX = "countries/xiyu/wugan.txt"
XYY = "countries/xiyu/xiye.txt"
XYZ = "countries/xiyu/zihe.txt"
AXY = "countries/xiyu/puli.txt"
BXY = "countries/xiyu/yinai.txt"
CXY = "countries/xiyu/xiaowan.txt"
DXY = "countries/xiyu/wulei.txt"
EXY = "countries/xiyu/taohuai.txt"
FXY = "countries/xiyu/xiuxun.txt"
GXY = "countries/xiyu/juandu.txt"
HXY = "countries/xiyu/shache.txt"
IXY = "countries/xiyu/shule.txt"
JXY = "countries/xiyu/weitou.txt"
KXY = "countries/xiyu/weixu.txt"
LXY = "countries/xiyu/yanzhe.txt"
MXY = "countries/xiyu/moshan.txt"
NXY = "countries/xiyu/huhu.txt"
OXY = "countries/xiyu/quli.txt"